0 0 0 0 0 0 0 0 0 0 0 0 0 0 0 0 0 0 0 0 0 0 0 0 0 0 0 0 0 0 0 0 0 0 0 0 0 0 0 0 0 0 0 0 0 0 0 0 0 0 0 0 0 0 0 0 0 0 0 0 0 0 0 0 0 0 0 0 0 0 0 0 0 0 0 0 0 0 0 0 0 0 0 0 0 0 0 0 0 0 0 0 0 0 0 0
0 0 0 0 0 0 0 0 0 0 0 0 0 0 0 0 0 0 0 0 0 0 0 0 0 0 0 0 0 0 0 0 0 0 0 0 0 0 0 0 0 0 0 0 0 0 0 0 0 0 0 0 0 0 0 0 0 0 0 0 0 0 0 0 0 0 0 0 0 0 0 0 0 0 0 0 0 0 0 0 0 0 0 0 0 0 0 0 0 0 0 0 0 0 0 0
0 0 850 850 875 900 925 950 975 1000 1025 1050 1075 1100 1125 1150 1175 1200 1225 1250 1275 1275 0 0 0 0 850 850 875 900 925 950 975 1000 1025 1050 1075 1100 1125 1150 1175 1200 1225 1250 1275 1275 0 0 0 0 850 850 875 900 925 950 975 1000 1025 1050 1075 1100 1125 1150 1175 1200 1225 1250 1275 1275 0 0 0 0 850 850 875 900 925 950 975 1000 1025 1050 1075 1100 1125 1150 1175 1200 1225 1250 1275 1275 0 0
0 0 850 850 875 900 925 950 975 1000 1025 1050 1075 1100 1125 1150 1175 1200 1225 1250 1275 1275 0 0 0 0 850 850 875 900 925 950 975 1000 1025 1050 1075 1100 1125 1150 1175 1200 1225 1250 1275 1275 0 0 0 0 850 850 875 900 925 950 975 1000 1025 1050 1075 1100 1125 1150 1175 1200 1225 1250 1275 1275 0 0 0 0 850 850 875 900 925 950 975 1000 1025 1050 1075 1100 1125 1150 1175 1200 1225 1250 1275 1275 0 0
0 0 825 825 2350 2350 2375 2400 2425 2450 2475 2500 2525 2550 2575 2600 2625 2650 2675 2675 1300 1300 0 0 0 0 825 825 2350 2350 2375 2400 2425 2450 2475 2500 2525 2550 2575 2600 2625 2650 2675 2675 1300 1300 0 0 0 0 825 825 2350 2350 2375 2400 2425 2450 2475 2500 2525 2550 2575 2600 2625 2650 2675 2675 1300 1300 0 0 0 0 825 825 2350 2350 2375 2400 2425 2450 2475 2500 2525 2550 2575 2600 2625 2650 2675 2675 1300 1300 0 0
0 0 800 800 2350 2350 2375 2400 2425 2450 2475 2500 2525 2550 2575 2600 2625 2650 2675 2675 1325 1325 0 0 0 0 800 800 2350 2350 2375 2400 2425 2450 2475 2500 2525 2550 2575 2600 2625 2650 2675 2675 1325 1325 0 0 0 0 800 800 2350 2350 2375 2400 2425 2450 2475 2500 2525 2550 2575 2600 2625 2650 2675 2675 1325 1325 0 0 0 0 800 800 2350 2350 2375 2400 2425 2450 2475 2500 2525 2550 2575 2600 2625 2650 2675 2675 1325 1325 0 0
0 0 775 775 2325 2325 3450 3450 3475 3500 3525 3550 3575 3600 3625 3650 3675 3675 2700 2700 1350 1350 0 0 0 0 775 775 2325 2325 3450 3450 3475 3500 3525 3550 3575 3600 3625 3650 3675 3675 2700 2700 1350 1350 0 0 0 0 775 775 2325 2325 3450 3450 3475 3500 3525 3550 3575 3600 3625 3650 3675 3675 2700 2700 1350 1350 0 0 0 0 775 775 2325 2325 3450 3450 3475 3500 3525 3550 3575 3600 3625 3650 3675 3675 2700 2700 1350 1350 0 0
0 0 750 750 2300 2300 3450 3450 3475 3500 3525 3550 3575 3600 3625 3650 3675 3675 2725 2725 1375 1375 0 0 0 0 750 750 2300 2300 3450 3450 3475 3500 3525 3550 3575 3600 3625 3650 3675 3675 2725 2725 1375 1375 0 0 0 0 750 750 2300 2300 3450 3450 3475 3500 3525 3550 3575 3600 3625 3650 3675 3675 2725 2725 1375 1375 0 0 0 0 750 750 2300 2300 3450 3450 3475 3500 3525 3550 3575 3600 3625 3650 3675 3675 2725 2725 1375 1375 0 0
0 0 725 725 2275 2275 3425 3425 4150 4150 4175 4200 4225 4250 4275 4275 3700 3700 2750 2750 1400 1400 0 0 0 0 725 725 2275 2275 3425 3425 4150 4150 4175 4200 4225 4250 4275 4275 3700 3700 2750 2750 1400 1400 0 0 0 0 725 725 2275 2275 3425 3425 4150 4150 4175 4200 4225 4250 4275 4275 3700 3700 2750 2750 1400 1400 0 0 0 0 725 725 2275 2275 3425 3425 4150 4150 4175 4200 4225 4250 4275 4275 3700 3700 2750 2750 1400 1400 0 0
0 0 700 700 2250 2250 3400 3400 4150 4150 4175 4200 4225 4250 4275 4275 3725 3725 2775 2775 1425 1425 0 0 0 0 700 700 2250 2250 3400 3400 4150 4150 4175 4200 4225 4250 4275 4275 3725 3725 2775 2775 1425 1425 0 0 0 0 700 700 2250 2250 3400 3400 4150 4150 4175 4200 4225 4250 4275 4275 3725 3725 2775 2775 1425 1425 0 0 0 0 700 700 2250 2250 3400 3400 4150 4150 4175 4200 4225 4250 4275 4275 3725 3725 2775 2775 1425 1425 0 0
0 0 675 675 2225 2225 3375 3375 4125 4125 4450 4450 4475 4475 4300 4300 3750 3750 2800 2800 1450 1450 0 0 0 0 675 675 2225 2225 3375 3375 4125 4125 4450 4450 4475 4475 4300 4300 3750 3750 2800 2800 1450 1450 0 0 0 0 675 675 2225 2225 3375 3375 4125 4125 4450 4450 4475 4475 4300 4300 3750 3750 2800 2800 1450 1450 0 0 0 0 675 675 2225 2225 3375 3375 4125 4125 4450 4450 4475 4475 4300 4300 3750 3750 2800 2800 1450 1450 0 0
0 0 650 650 2200 2200 3350 3350 4100 4100 4450 4450 4475 4475 4325 4325 3775 3775 2825 2825 1475 1475 0 0 0 0 650 650 2200 2200 3350 3350 4100 4100 4450 4450 4475 4475 4325 4325 3775 3775 2825 2825 1475 1475 0 0 0 0 650 650 2200 2200 3350 3350 4100 4100 4450 4450 4475 4475 4325 4325 3775 3775 2825 2825 1475 1475 0 0 0 0 650 650 2200 2200 3350 3350 4100 4100 4450 4450 4475 4475 4325 4325 3775 3775 2825 2825 1475 1475 0 0
0 0 625 625 2175 2175 3325 3325 4075 4075 4425 4425 4400 4375 4350 4350 3800 3800 2850 2850 1500 1500 0 0 0 0 625 625 2175 2175 3325 3325 4075 4075 4425 4425 4400 4375 4350 4350 3800 3800 2850 2850 1500 1500 0 0 0 0 625 625 2175 2175 3325 3325 4075 4075 4425 4425 4400 4375 4350 4350 3800 3800 2850 2850 1500 1500 0 0 0 0 625 625 2175 2175 3325 3325 4075 4075 4425 4425 4400 4375 4350 4350 3800 3800 2850 2850 1500 1500 0 0
0 0 600 600 2150 2150 3300 3300 4050 4050 4425 4425 4400 4375 4350 4350 3825 3825 2875 2875 1525 1525 0 0 0 0 600 600 2150 2150 3300 3300 4050 4050 4425 4425 4400 4375 4350 4350 3825 3825 2875 2875 1525 1525 0 0 0 0 600 600 2150 2150 3300 3300 4050 4050 4425 4425 4400 4375 4350 4350 3825 3825 2875 2875 1525 1525 0 0 0 0 600 600 2150 2150 3300 3300 4050 4050 4425 4425 4400 4375 4350 4350 3825 3825 2875 2875 1525 1525 0 0
0 0 575 575 2125 2125 3275 3275 4025 4025 4000 3975 3950 3925 3900 3875 3850 3850 2900 2900 1550 1550 0 0 0 0 575 575 2125 2125 3275 3275 4025 4025 4000 3975 3950 3925 3900 3875 3850 3850 2900 2900 1550 1550 0 0 0 0 575 575 2125 2125 3275 3275 4025 4025 4000 3975 3950 3925 3900 3875 3850 3850 2900 2900 1550 1550 0 0 0 0 575 575 2125 2125 3275 3275 4025 4025 4000 3975 3950 3925 3900 3875 3850 3850 2900 2900 1550 1550 0 0
0 0 550 550 2100 2100 3250 3250 4025 4025 4000 3975 3950 3925 3900 3875 3850 3850 2925 2925 1575 1575 0 0 0 0 550 550 2100 2100 3250 3250 4025 4025 4000 3975 3950 3925 3900 3875 3850 3850 2925 2925 1575 1575 0 0 0 0 550 550 2100 2100 3250 3250 4025 4025 4000 3975 3950 3925 3900 3875 3850 3850 2925 2925 1575 1575 0 0 0 0 550 550 2100 2100 3250 3250 4025 4025 4000 3975 3950 3925 3900 3875 3850 3850 2925 2925 1575 1575 0 0
0 0 525 525 2075 2075 3225 3225 3200 3175 3150 3125 3100 3075 3050 3025 3000 2975 2950 2950 1600 1600 0 0 0 0 525 525 2075 2075 3225 3225 3200 3175 3150 3125 3100 3075 3050 3025 3000 2975 2950 2950 1600 1600 0 0 0 0 525 525 2075 2075 3225 3225 3200 3175 3150 3125 3100 3075 3050 3025 3000 2975 2950 2950 1600 1600 0 0 0 0 525 525 2075 2075 3225 3225 3200 3175 3150 3125 3100 3075 3050 3025 3000 2975 2950 2950 1600 1600 0 0
0 0 500 500 2050 2050 3225 3225 3200 3175 3150 3125 3100 3075 3050 3025 3000 2975 2950 2950 1625 1625 0 0 0 0 500 500 2050 2050 3225 3225 3200 3175 3150 3125 3100 3075 3050 3025 3000 2975 2950 2950 1625 1625 0 0 0 0 500 500 2050 2050 3225 3225 3200 3175 3150 3125 3100 3075 3050 3025 3000 2975 2950 2950 1625 1625 0 0 0 0 500 500 2050 2050 3225 3225 3200 3175 3150 3125 3100 3075 3050 3025 3000 2975 2950 2950 1625 1625 0 0
0 0 475 475 2025 2025 2000 1975 1950 1925 1900 1875 1850 1825 1800 1775 1750 1725 1700 1675 1650 1650 0 0 0 0 475 475 2025 2025 2000 1975 1950 1925 1900 1875 1850 1825 1800 1775 1750 1725 1700 1675 1650 1650 0 0 0 0 475 475 2025 2025 2000 1975 1950 1925 1900 1875 1850 1825 1800 1775 1750 1725 1700 1675 1650 1650 0 0 0 0 475 475 2025 2025 2000 1975 1950 1925 1900 1875 1850 1825 1800 1775 1750 1725 1700 1675 1650 1650 0 0
0 0 450 450 2025 2025 2000 1975 1950 1925 1900 1875 1850 1825 1800 1775 1750 1725 1700 1675 1650 1650 0 0 0 0 450 450 2025 2025 2000 1975 1950 1925 1900 1875 1850 1825 1800 1775 1750 1725 1700 1675 1650 1650 0 0 0 0 450 450 2025 2025 2000 1975 1950 1925 1900 1875 1850 1825 1800 1775 1750 1725 1700 1675 1650 1650 0 0 0 0 450 450 2025 2025 2000 1975 1950 1925 1900 1875 1850 1825 1800 1775 1750 1725 1700 1675 1650 1650 0 0
0 0 425 425 400 375 350 325 300 275 250 225 200 175 150 125 100 75 50 25 0 0 0 0 0 0 425 425 400 375 350 325 300 275 250 225 200 175 150 125 100 75 50 25 0 0 0 0 0 0 425 425 400 375 350 325 300 275 250 225 200 175 150 125 100 75 50 25 0 0 0 0 0 0 425 425 400 375 350 325 300 275 250 225 200 175 150 125 100 75 50 25 0 0 0 0
0 0 425 425 400 375 350 325 300 275 250 225 200 175 150 125 100 75 50 25 0 0 0 0 0 0 425 425 400 375 350 325 300 275 250 225 200 175 150 125 100 75 50 25 0 0 0 0 0 0 425 425 400 375 350 325 300 275 250 225 200 175 150 125 100 75 50 25 0 0 0 0 0 0 425 425 400 375 350 325 300 275 250 225 200 175 150 125 100 75 50 25 0 0 0 0
0 0 0 0 0 0 0 0 0 0 0 0 0 0 0 0 0 0 0 0 0 0 0 0 0 0 0 0 0 0 0 0 0 0 0 0 0 0 0 0 0 0 0 0 0 0 0 0 0 0 0 0 0 0 0 0 0 0 0 0 0 0 0 0 0 0 0 0 0 0 0 0 0 0 0 0 0 0 0 0 0 0 0 0 0 0 0 0 0 0 0 0 0 0 0 0
0 0 0 0 0 0 0 0 0 0 0 0 0 0 0 0 0 0 0 0 0 0 0 0 0 0 0 0 0 0 0 0 0 0 0 0 0 0 0 0 0 0 0 0 0 0 0 0 0 0 0 0 0 0 0 0 0 0 0 0 0 0 0 0 0 0 0 0 0 0 0 0 0 0 0 0 0 0 0 0 0 0 0 0 0 0 0 0 0 0 0 0 0 0 0 0
0 0 0 0 0 0 0 0 0 0 0 0 0 0 0 0 0 0 0 0 0 0 0 0 0 0 0 0 0 0 0 0 0 0 0 0 0 0 0 0 0 0 0 0 0 0 0 0 0 0 0 0 0 0 0 0 0 0 0 0 0 0 0 0 0 0 0 0 0 0 0 0 0 0 0 0 0 0 0 0 0 0 0 0 0 0 0 0 0 0 0 0 0 0 0 0
0 0 0 0 0 0 0 0 0 0 0 0 0 0 0 0 0 0 0 0 0 0 0 0 0 0 0 0 0 0 0 0 0 0 0 0 0 0 0 0 0 0 0 0 0 0 0 0 0 0 0 0 0 0 0 0 0 0 0 0 0 0 0 0 0 0 0 0 0 0 0 0 0 0 0 0 0 0 0 0 0 0 0 0 0 0 0 0 0 0 0 0 0 0 0 0
0 0 850 850 875 900 925 950 975 1000 1025 1050 1075 1100 1125 1150 1175 1200 1225 1250 1275 1275 0 0 0 0 850 850 875 900 925 950 975 1000 1025 1050 1075 1100 1125 1150 1175 1200 1225 1250 1275 1275 0 0 0 0 850 850 875 900 925 950 975 1000 1025 1050 1075 1100 1125 1150 1175 1200 1225 1250 1275 1275 0 0 0 0 850 850 875 900 925 950 975 1000 1025 1050 1075 1100 1125 1150 1175 1200 1225 1250 1275 1275 0 0
0 0 850 850 875 900 925 950 975 1000 1025 1050 1075 1100 1125 1150 1175 1200 1225 1250 1275 1275 0 0 0 0 850 850 875 900 925 950 975 1000 1025 1050 1075 1100 1125 1150 1175 1200 1225 1250 1275 1275 0 0 0 0 850 850 875 900 925 950 975 1000 1025 1050 1075 1100 1125 1150 1175 1200 1225 1250 1275 1275 0 0 0 0 850 850 875 900 925 950 975 1000 1025 1050 1075 1100 1125 1150 1175 1200 1225 1250 1275 1275 0 0
0 0 825 825 2350 2350 2375 2400 2425 2450 2475 2500 2525 2550 2575 2600 2625 2650 2675 2675 1300 1300 0 0 0 0 825 825 2350 2350 2375 2400 2425 2450 2475 2500 2525 2550 2575 2600 2625 2650 2675 2675 1300 1300 0 0 0 0 825 825 2350 2350 2375 2400 2425 2450 2475 2500 2525 2550 2575 2600 2625 2650 2675 2675 1300 1300 0 0 0 0 825 825 2350 2350 2375 2400 2425 2450 2475 2500 2525 2550 2575 2600 2625 2650 2675 2675 1300 1300 0 0
0 0 800 800 2350 2350 2375 2400 2425 2450 2475 2500 2525 2550 2575 2600 2625 2650 2675 2675 1325 1325 0 0 0 0 800 800 2350 2350 2375 2400 2425 2450 2475 2500 2525 2550 2575 2600 2625 2650 2675 2675 1325 1325 0 0 0 0 800 800 2350 2350 2375 2400 2425 2450 2475 2500 2525 2550 2575 2600 2625 2650 2675 2675 1325 1325 0 0 0 0 800 800 2350 2350 2375 2400 2425 2450 2475 2500 2525 2550 2575 2600 2625 2650 2675 2675 1325 1325 0 0
0 0 775 775 2325 2325 3450 3450 3475 3500 3525 3550 3575 3600 3625 3650 3675 3675 2700 2700 1350 1350 0 0 0 0 775 775 2325 2325 3450 3450 3475 3500 3525 3550 3575 3600 3625 3650 3675 3675 2700 2700 1350 1350 0 0 0 0 775 775 2325 2325 3450 3450 3475 3500 3525 3550 3575 3600 3625 3650 3675 3675 2700 2700 1350 1350 0 0 0 0 775 775 2325 2325 3450 3450 3475 3500 3525 3550 3575 3600 3625 3650 3675 3675 2700 2700 1350 1350 0 0
0 0 750 750 2300 2300 3450 3450 3475 3500 3525 3550 3575 3600 3625 3650 3675 3675 2725 2725 1375 1375 0 0 0 0 750 750 2300 2300 3450 3450 3475 3500 3525 3550 3575 3600 3625 3650 3675 3675 2725 2725 1375 1375 0 0 0 0 750 750 2300 2300 3450 3450 3475 3500 3525 3550 3575 3600 3625 3650 3675 3675 2725 2725 1375 1375 0 0 0 0 750 750 2300 2300 3450 3450 3475 3500 3525 3550 3575 3600 3625 3650 3675 3675 2725 2725 1375 1375 0 0
0 0 725 725 2275 2275 3425 3425 4150 4150 4175 4200 4225 4250 4275 4275 3700 3700 2750 2750 1400 1400 0 0 0 0 725 725 2275 2275 3425 3425 4150 4150 4175 4200 4225 4250 4275 4275 3700 3700 2750 2750 1400 1400 0 0 0 0 725 725 2275 2275 3425 3425 4150 4150 4175 4200 4225 4250 4275 4275 3700 3700 2750 2750 1400 1400 0 0 0 0 725 725 2275 2275 3425 3425 4150 4150 4175 4200 4225 4250 4275 4275 3700 3700 2750 2750 1400 1400 0 0
0 0 700 700 2250 2250 3400 3400 4150 4150 4175 4200 4225 4250 4275 4275 3725 3725 2775 2775 1425 1425 0 0 0 0 700 700 2250 2250 3400 3400 4150 4150 4175 4200 4225 4250 4275 4275 3725 3725 2775 2775 1425 1425 0 0 0 0 700 700 2250 2250 3400 3400 4150 4150 4175 4200 4225 4250 4275 4275 3725 3725 2775 2775 1425 1425 0 0 0 0 700 700 2250 2250 3400 3400 4150 4150 4175 4200 4225 4250 4275 4275 3725 3725 2775 2775 1425 1425 0 0
0 0 675 675 2225 2225 3375 3375 4125 4125 4450 4450 4475 4475 4300 4300 3750 3750 2800 2800 1450 1450 0 0 0 0 675 675 2225 2225 3375 3375 4125 4125 4450 4450 4475 4475 4300 4300 3750 3750 2800 2800 1450 1450 0 0 0 0 675 675 2225 2225 3375 3375 4125 4125 4450 4450 4475 4475 4300 4300 3750 3750 2800 2800 1450 1450 0 0 0 0 675 675 2225 2225 3375 3375 4125 4125 4450 4450 4475 4475 4300 4300 3750 3750 2800 2800 1450 1450 0 0
0 0 650 650 2200 2200 3350 3350 4100 4100 4450 4450 4475 4475 4325 4325 3775 3775 2825 2825 1475 1475 0 0 0 0 650 650 2200 2200 3350 3350 4100 4100 4450 4450 4475 4475 4325 4325 3775 3775 2825 2825 1475 1475 0 0 0 0 650 650 2200 2200 3350 3350 4100 4100 4450 4450 4475 4475 4325 4325 3775 3775 2825 2825 1475 1475 0 0 0 0 650 650 2200 2200 3350 3350 4100 4100 4450 4450 4475 4475 4325 4325 3775 3775 2825 2825 1475 1475 0 0
0 0 625 625 2175 2175 3325 3325 4075 4075 4425 4425 4400 4375 4350 4350 3800 3800 2850 2850 1500 1500 0 0 0 0 625 625 2175 2175 3325 3325 4075 4075 4425 4425 4400 4375 4350 4350 3800 3800 2850 2850 1500 1500 0 0 0 0 625 625 2175 2175 3325 3325 4075 4075 4425 4425 4400 4375 4350 4350 3800 3800 2850 2850 1500 1500 0 0 0 0 625 625 2175 2175 3325 3325 4075 4075 4425 4425 4400 4375 4350 4350 3800 3800 2850 2850 1500 1500 0 0
0 0 600 600 2150 2150 3300 3300 4050 4050 4425 4425 4400 4375 4350 4350 3825 3825 2875 2875 1525 1525 0 0 0 0 600 600 2150 2150 3300 3300 4050 4050 4425 4425 4400 4375 4350 4350 3825 3825 2875 2875 1525 1525 0 0 0 0 600 600 2150 2150 3300 3300 4050 4050 4425 4425 4400 4375 4350 4350 3825 3825 2875 2875 1525 1525 0 0 0 0 600 600 2150 2150 3300 3300 4050 4050 4425 4425 4400 4375 4350 4350 3825 3825 2875 2875 1525 1525 0 0
0 0 575 575 2125 2125 3275 3275 4025 4025 4000 3975 3950 3925 3900 3875 3850 3850 2900 2900 1550 1550 0 0 0 0 575 575 2125 2125 3275 3275 4025 4025 4000 3975 3950 3925 3900 3875 3850 3850 2900 2900 1550 1550 0 0 0 0 575 575 2125 2125 3275 3275 4025 4025 4000 3975 3950 3925 3900 3875 3850 3850 2900 2900 1550 1550 0 0 0 0 575 575 2125 2125 3275 3275 4025 4025 4000 3975 3950 3925 3900 3875 3850 3850 2900 2900 1550 1550 0 0
0 0 550 550 2100 2100 3250 3250 4025 4025 4000 3975 3950 3925 3900 3875 3850 3850 2925 2925 1575 1575 0 0 0 0 550 550 2100 2100 3250 3250 4025 4025 4000 3975 3950 3925 3900 3875 3850 3850 2925 2925 1575 1575 0 0 0 0 550 550 2100 2100 3250 3250 4025 4025 4000 3975 3950 3925 3900 3875 3850 3850 2925 2925 1575 1575 0 0 0 0 550 550 2100 2100 3250 3250 4025 4025 4000 3975 3950 3925 3900 3875 3850 3850 2925 2925 1575 1575 0 0
0 0 525 525 2075 2075 3225 3225 3200 3175 3150 3125 3100 3075 3050 3025 3000 2975 2950 2950 1600 1600 0 0 0 0 525 525 2075 2075 3225 3225 3200 3175 3150 3125 3100 3075 3050 3025 3000 2975 2950 2950 1600 1600 0 0 0 0 525 525 2075 2075 3225 3225 3200 3175 3150 3125 3100 3075 3050 3025 3000 2975 2950 2950 1600 1600 0 0 0 0 525 525 2075 2075 3225 3225 3200 3175 3150 3125 3100 3075 3050 3025 3000 2975 2950 2950 1600 1600 0 0
0 0 500 500 2050 2050 3225 3225 3200 3175 3150 3125 3100 3075 3050 3025 3000 2975 2950 2950 1625 1625 0 0 0 0 500 500 2050 2050 3225 3225 3200 3175 3150 3125 3100 3075 3050 3025 3000 2975 2950 2950 1625 1625 0 0 0 0 500 500 2050 2050 3225 3225 3200 3175 3150 3125 3100 3075 3050 3025 3000 2975 2950 2950 1625 1625 0 0 0 0 500 500 2050 2050 3225 3225 3200 3175 3150 3125 3100 3075 3050 3025 3000 2975 2950 2950 1625 1625 0 0
0 0 475 475 2025 2025 2000 1975 1950 1925 1900 1875 1850 1825 1800 1775 1750 1725 1700 1675 1650 1650 0 0 0 0 475 475 2025 2025 2000 1975 1950 1925 1900 1875 1850 1825 1800 1775 1750 1725 1700 1675 1650 1650 0 0 0 0 475 475 2025 2025 2000 1975 1950 1925 1900 1875 1850 1825 1800 1775 1750 1725 1700 1675 1650 1650 0 0 0 0 475 475 2025 2025 2000 1975 1950 1925 1900 1875 1850 1825 1800 1775 1750 1725 1700 1675 1650 1650 0 0
0 0 450 450 2025 2025 2000 1975 1950 1925 1900 1875 1850 1825 1800 1775 1750 1725 1700 1675 1650 1650 0 0 0 0 450 450 2025 2025 2000 1975 1950 1925 1900 1875 1850 1825 1800 1775 1750 1725 1700 1675 1650 1650 0 0 0 0 450 450 2025 2025 2000 1975 1950 1925 1900 1875 1850 1825 1800 1775 1750 1725 1700 1675 1650 1650 0 0 0 0 450 450 2025 2025 2000 1975 1950 1925 1900 1875 1850 1825 1800 1775 1750 1725 1700 1675 1650 1650 0 0
0 0 425 425 400 375 350 325 300 275 250 225 200 175 150 125 100 75 50 25 0 0 0 0 0 0 425 425 400 375 350 325 300 275 250 225 200 175 150 125 100 75 50 25 0 0 0 0 0 0 425 425 400 375 350 325 300 275 250 225 200 175 150 125 100 75 50 25 0 0 0 0 0 0 425 425 400 375 350 325 300 275 250 225 200 175 150 125 100 75 50 25 0 0 0 0
0 0 425 425 400 375 350 325 300 275 250 225 200 175 150 125 100 75 50 25 0 0 0 0 0 0 425 425 400 375 350 325 300 275 250 225 200 175 150 125 100 75 50 25 0 0 0 0 0 0 425 425 400 375 350 325 300 275 250 225 200 175 150 125 100 75 50 25 0 0 0 0 0 0 425 425 400 375 350 325 300 275 250 225 200 175 150 125 100 75 50 25 0 0 0 0
0 0 0 0 0 0 0 0 0 0 0 0 0 0 0 0 0 0 0 0 0 0 0 0 0 0 0 0 0 0 0 0 0 0 0 0 0 0 0 0 0 0 0 0 0 0 0 0 0 0 0 0 0 0 0 0 0 0 0 0 0 0 0 0 0 0 0 0 0 0 0 0 0 0 0 0 0 0 0 0 0 0 0 0 0 0 0 0 0 0 0 0 0 0 0 0
0 0 0 0 0 0 0 0 0 0 0 0 0 0 0 0 0 0 0 0 0 0 0 0 0 0 0 0 0 0 0 0 0 0 0 0 0 0 0 0 0 0 0 0 0 0 0 0 0 0 0 0 0 0 0 0 0 0 0 0 0 0 0 0 0 0 0 0 0 0 0 0 0 0 0 0 0 0 0 0 0 0 0 0 0 0 0 0 0 0 0 0 0 0 0 0
