0 0 0 0 0 0 0 0 0 0 0 0 0 0 0 0 0 0 0 0 0 0 0 0
0 0 0 0 0 0 0 0 0 0 0 0 0 0 0 0 0 0 0 0 0 0 0 0
0 0 900 900 950 950 1000 1000 1050 1050 1100 1100 1150 1150 1200 1200 1250 1250 1300 1300 1350 1350 0 0
0 0 900 900 950 950 1000 1000 1050 1050 1100 1100 1150 1150 1200 1200 1250 1250 1300 1300 1350 1350 0 0
0 0 850 850 2500 2500 2550 2550 2600 2600 2650 2650 2700 2700 2750 2750 2800 2800 2850 2850 1400 1400 0 0
0 0 850 850 2500 2500 2550 2550 2600 2600 2650 2650 2700 2700 2750 2750 2800 2800 2850 2850 1400 1400 0 0
0 0 800 800 2450 2450 3700 3700 3750 3750 3800 3800 3850 3850 3900 3900 3950 3950 2900 2900 1450 1450 0 0
0 0 800 800 2450 2450 3700 3700 3750 3750 3800 3800 3850 3850 3900 3900 3950 3950 2900 2900 1450 1450 0 0
0 0 750 750 2400 2400 3650 3650 4500 4500 4550 4550 4600 4600 4650 4650 4000 4000 2950 2950 1500 1500 0 0
0 0 750 750 2400 2400 3650 3650 4500 4500 4550 4550 4600 4600 4650 4650 4000 4000 2950 2950 1500 1500 0 0
0 0 700 700 2350 2350 3600 3600 4450 4450 4900 4900 4950 4950 4700 4700 4050 4050 3000 3000 1550 1550 0 0
0 0 700 700 2350 2350 3600 3600 4450 4450 4900 4900 4950 4950 4700 4700 4050 4050 3000 3000 1550 1550 0 0
0 0 650 650 2300 2300 3550 3550 4400 4400 4850 4850 4800 4800 4750 4750 4100 4100 3050 3050 1600 1600 0 0
0 0 650 650 2300 2300 3550 3550 4400 4400 4850 4850 4800 4800 4750 4750 4100 4100 3050 3050 1600 1600 0 0
0 0 600 600 2250 2250 3500 3500 4350 4350 4300 4300 4250 4250 4200 4200 4150 4150 3100 3100 1650 1650 0 0
0 0 600 600 2250 2250 3500 3500 4350 4350 4300 4300 4250 4250 4200 4200 4150 4150 3100 3100 1650 1650 0 0
0 0 550 550 2200 2200 3450 3450 3400 3400 3350 3350 3300 3300 3250 3250 3200 3200 3150 3150 1700 1700 0 0
0 0 550 550 2200 2200 3450 3450 3400 3400 3350 3350 3300 3300 3250 3250 3200 3200 3150 3150 1700 1700 0 0
0 0 500 500 2150 2150 2100 2100 2050 2050 2000 2000 1950 1950 1900 1900 1850 1850 1800 1800 1750 1750 0 0
0 0 500 500 2150 2150 2100 2100 2050 2050 2000 2000 1950 1950 1900 1900 1850 1850 1800 1800 1750 1750 0 0
0 0 450 450 400 400 350 350 300 300 250 250 200 200 150 150 100 100 50 50 0 0 0 0
0 0 450 450 400 400 350 350 300 300 250 250 200 200 150 150 100 100 50 50 0 0 0 0
0 0 0 0 0 0 0 0 0 0 0 0 0 0 0 0 0 0 0 0 0 0 0 0
0 0 0 0 0 0 0 0 0 0 0 0 0 0 0 0 0 0 0 0 0 0 0 0