0 0 0 0 0 0 0 0 0 0 0 0 0 0 0 0 0 0 0 0 0 0 0 0 0 0 0 0 0 0 0 0 0 0 0 0 0 0 0 0 0 0 0 0 0 0 0 0 0 0 0 0 0 0 0 0 0 0 0 0 0 0 0
0 223 223 223 223 223 223 223 223 223 223 223 223 223 223 223 223 0 0 0 0 0 0 0 0 0 0 0 0 0 0 0 0 0 0 0 0 0 0 0 0 0 0 0 0 0 223 223 223 223 223 223 223 223 223 223 223 223 223 223 223 223 0
0 223 446 446 446 446 446 446 446 446 446 446 446 446 446 446 446 0 0 0 0 0 0 0 0 0 0 0 0 0 0 0 0 0 0 0 0 0 0 0 0 0 0 0 0 0 446 446 446 446 446 446 446 446 446 446 446 446 446 446 446 223 0
0 223 446 669 669 669 669 669 669 669 669 669 669 669 669 669 669 0 0 0 0 0 0 0 0 0 0 0 0 0 0 0 0 0 0 0 0 0 0 0 0 0 0 0 0 0 669 669 669 669 669 669 669 669 669 669 669 669 669 669 446 223 0
0 223 446 669 892 892 892 892 892 892 892 892 892 892 892 892 892 0 0 0 0 0 0 0 0 0 0 0 0 0 0 0 0 0 0 0 0 0 0 0 0 0 0 0 0 0 892 892 892 892 892 892 892 892 892 892 892 892 892 669 446 223 0
0 223 446 669 892 1115 1115 1115 1115 1115 1115 1115 1115 1115 1115 1115 1115 0 0 0 0 0 0 0 0 0 0 0 0 0 0 0 0 0 0 0 0 0 0 0 0 0 0 0 0 0 1115 1115 1115 1115 1115 1115 1115 1115 1115 1115 1115 1115 892 669 446 223 0
0 223 446 669 892 1115 1338 1338 1338 1338 1338 1338 1338 1338 1338 1338 1338 0 0 0 0 0 0 0 0 0 0 0 0 0 0 0 0 0 0 0 0 0 0 0 0 0 0 0 0 0 1338 1338 1338 1338 1338 1338 1338 1338 1338 1338 1338 1115 892 669 446 223 0
0 223 446 669 892 1115 1338 1561 1561 1561 1561 1561 1561 1561 1561 1561 1561 0 0 0 0 0 0 0 0 0 0 0 0 0 0 0 0 0 0 0 0 0 0 0 0 0 0 0 0 0 1561 1561 1561 1561 1561 1561 1561 1561 1561 1561 1338 1115 892 669 446 223 0
0 223 446 669 892 1115 1338 1561 1784 1784 1784 1784 1784 1784 1784 1784 1784 0 0 0 0 0 0 0 0 0 0 0 0 0 0 0 0 0 0 0 0 0 0 0 0 0 0 0 0 0 1784 1784 1784 1784 1784 1784 1784 1784 1784 1561 1338 1115 892 669 446 223 0
0 223 446 669 892 1115 1338 1561 1784 2007 2007 2007 2007 2007 2007 2007 2007 0 0 0 0 0 0 0 0 0 0 0 0 0 0 0 0 0 0 0 0 0 0 0 0 0 0 0 0 0 2007 2007 2007 2007 2007 2007 2007 2007 1784 1561 1338 1115 892 669 446 223 0
0 223 446 669 892 1115 1338 1561 1784 2007 2230 2230 2230 2230 2230 2230 2230 0 0 0 0 0 0 0 0 0 0 0 0 0 0 0 0 0 0 0 0 0 0 0 0 0 0 0 0 0 2230 2230 2230 2230 2230 2230 2230 2007 1784 1561 1338 1115 892 669 446 223 0
0 223 446 669 892 1115 1338 1561 1784 2007 2230 2453 2453 2453 2453 2453 2453 0 0 0 0 0 0 0 0 0 0 0 0 0 0 0 0 0 0 0 0 0 0 0 0 0 0 0 0 0 2453 2453 2453 2453 2453 2453 2230 2007 1784 1561 1338 1115 892 669 446 223 0
0 223 446 669 892 1115 1338 1561 1784 2007 2230 2453 2676 2676 2676 2676 2676 0 0 0 0 0 0 0 0 0 0 0 0 0 0 0 0 0 0 0 0 0 0 0 0 0 0 0 0 0 2676 2676 2676 2676 2676 2453 2230 2007 1784 1561 1338 1115 892 669 446 223 0
0 223 446 669 892 1115 1338 1561 1784 2007 2230 2453 2676 2900 2900 2900 2900 2900 2900 2900 2900 2900 2900 2900 2900 2900 2900 2900 2900 2900 2900 2900 2900 2900 2900 2900 2900 2900 2900 2900 2900 2900 2900 2900 2900 2900 2900 2900 2900 2900 2676 2453 2230 2007 1784 1561 1338 1115 892 669 446 223 0
0 223 446 669 892 1115 1338 1561 1784 2007 2230 2453 2676 2900 2900 2900 2900 2900 2900 2900 2900 2900 2900 2900 2900 2900 2900 2900 2900 2900 2900 2900 2900 2900 2900 2900 2900 2900 2900 2900 2900 2900 2900 2900 2900 2900 2900 2900 2900 2900 2676 2453 2230 2007 1784 1561 1338 1115 892 669 446 223 0
0 223 446 669 892 1115 1338 1561 1784 2007 2230 2453 2676 2900 2900 2900 2900 2900 2900 2900 2900 2900 2900 2900 2900 2900 2900 2900 2900 2900 2900 2900 2900 2900 2900 2900 2900 2900 2900 2900 2900 2900 2900 2900 2900 2900 2900 2900 2900 2900 2676 2453 2230 2007 1784 1561 1338 1115 892 669 446 223 0
0 223 446 669 892 1115 1338 1561 1784 2007 2230 2453 2676 2900 2900 2900 3240 3240 3240 3240 3240 3240 3240 3240 3240 2900 2900 2900 2900 2900 2900 2900 2900 2900 2900 2900 2900 2900 3240 3240 3240 3240 3240 3240 3240 3240 3240 2900 2900 2900 2676 2453 2230 2007 1784 1561 1338 1115 892 669 446 223 0
0 0 0 0 0 0 0 0 0 0 0 0 0 2900 2900 2900 3240 3700 3700 3700 3700 3700 3700 3700 3700 2900 2900 2900 2900 2900 2900 2900 2900 2900 2900 2900 2900 2900 3700 3700 3700 3700 3700 3700 3700 3700 3240 2900 2900 2900 0 0 0 0 0 0 0 0 0 0 0 0 0
0 0 0 0 0 0 0 0 0 0 0 0 0 2900 2900 2900 3240 3700 4280 4280 4280 4280 4280 4280 4280 2900 2900 2900 2900 2900 2900 2900 2900 2900 2900 2900 2900 2900 4280 4280 4280 4280 4280 4280 4280 3700 3240 2900 2900 2900 0 0 0 0 0 0 0 0 0 0 0 0 0
0 0 0 0 0 0 0 0 0 0 0 0 0 2900 2900 2900 3240 3700 4280 4980 4980 4980 4980 4980 4980 2900 2900 2900 2900 2900 2900 2900 2900 2900 2900 2900 2900 2900 4980 4980 4980 4980 4980 4980 4280 3700 3240 2900 2900 2900 0 0 0 0 0 0 0 0 0 0 0 0 0
0 0 0 0 0 0 0 0 0 0 0 0 0 2900 2900 2900 3240 3700 4280 4980 5800 5800 5800 5800 5800 5800 5800 5800 5800 5800 5800 5800 5800 5800 5800 5800 5800 5800 5800 5800 5800 5800 5800 4980 4280 3700 3240 2900 2900 2900 0 0 0 0 0 0 0 0 0 0 0 0 0
0 0 0 0 0 0 0 0 0 0 0 0 0 2900 2900 2900 3240 3700 4280 4980 5800 5800 5800 5800 5800 5800 5800 5800 5800 5800 5800 5800 5800 5800 5800 5800 5800 5800 5800 5800 5800 5800 5800 4980 4280 3700 3240 2900 2900 2900 0 0 0 0 0 0 0 0 0 0 0 0 0
0 0 0 0 0 0 0 0 0 0 0 0 0 2900 2900 2900 3240 3700 4280 4980 5800 5800 7220 7220 7220 7220 7220 7220 7220 7220 7220 7220 7220 7220 7220 7220 7220 7220 7220 7220 7220 5800 5800 4980 4280 3700 3240 2900 2900 2900 0 0 0 0 0 0 0 0 0 0 0 0 0
0 0 0 0 0 0 0 0 0 0 0 0 0 2900 2900 2900 3240 3700 4280 4980 5800 5800 7220 8740 8740 8740 8740 8740 8740 8740 8740 8740 8740 8740 8740 8740 8740 8740 8740 8740 7220 5800 5800 4980 4280 3700 3240 2900 2900 2900 0 0 0 0 0 0 0 0 0 0 0 0 0
0 0 0 0 0 0 0 0 0 0 0 0 0 2900 2900 2900 2900 2900 2900 2900 5800 5800 7220 8740 10360 10360 10360 10360 10360 10360 10360 10360 10360 10360 10360 10360 10360 10360 10360 8740 7220 5800 5800 2900 2900 2900 2900 2900 2900 2900 0 0 0 0 0 0 0 0 0 0 0 0 0
0 0 0 0 0 0 0 0 0 0 0 0 0 2900 2900 2900 2900 2900 2900 2900 5800 5800 7220 8740 10360 12080 12080 12080 12080 12080 12080 12080 12080 12080 12080 12080 12080 12080 10360 8740 7220 5800 5800 2900 2900 2900 2900 2900 2900 2900 0 0 0 0 0 0 0 0 0 0 0 0 0
0 0 0 0 0 0 0 0 0 0 0 0 0 2900 2900 2900 2900 2900 2900 2900 5800 5800 7220 8740 10360 12080 13900 13900 13900 13900 13900 13900 13900 13900 13900 13900 13900 12080 10360 8740 7220 5800 5800 2900 2900 2900 2900 2900 2900 2900 0 0 0 0 0 0 0 0 0 0 0 0 0
0 0 0 0 0 0 0 0 0 0 0 0 0 2900 2900 2900 2900 2900 2900 2900 5800 5800 7220 8740 10360 12080 13900 13900 13900 13900 13900 13900 13900 13900 13900 13900 13900 12080 10360 8740 7220 5800 5800 2900 2900 2900 2900 2900 2900 2900 0 0 0 0 0 0 0 0 0 0 0 0 0
0 0 0 0 0 0 0 0 0 0 0 0 0 2900 2900 2900 2900 2900 2900 2900 5800 5800 7220 8740 10360 12080 13900 13900 14400 14400 14400 14400 14400 14400 14400 13900 13900 12080 10360 8740 7220 5800 5800 2900 2900 2900 2900 2900 2900 2900 0 0 0 0 0 0 0 0 0 0 0 0 0
0 0 0 0 0 0 0 0 0 0 0 0 0 2900 2900 2900 2900 2900 2900 2900 5800 5800 7220 8740 10360 12080 13900 13900 14400 14800 14900 15000 14900 14800 14400 13900 13900 12080 10360 8740 7220 5800 5800 2900 2900 2900 2900 2900 2900 2900 0 0 0 0 0 0 0 0 0 0 0 0 0
0 0 0 0 0 0 0 0 0 0 0 0 0 2900 2900 2900 2900 2900 2900 2900 5800 5800 7220 8740 10360 12080 13900 13900 14400 14900 15100 15300 15100 14900 14400 13900 13900 12080 10360 8740 7220 5800 5800 2900 2900 2900 2900 2900 2900 2900 0 0 0 0 0 0 0 0 0 0 0 0 0
0 0 0 0 0 0 0 0 0 0 0 0 0 2900 2900 2900 2900 2900 2900 2900 5800 5800 7220 8740 10360 12080 13900 13900 14400 15000 15300 16300 15300 15000 14400 13900 13900 12080 10360 8740 7220 5800 5800 2900 2900 2900 2900 2900 2900 2900 0 0 0 0 0 0 0 0 0 0 0 0 0
0 0 0 0 0 0 0 0 0 0 0 0 0 2900 2900 2900 2900 2900 2900 2900 5800 5800 7220 8740 10360 12080 13900 13900 14400 14900 15100 15300 15100 14900 14400 13900 13900 12080 10360 8740 7220 5800 5800 2900 2900 2900 2900 2900 2900 2900 0 0 0 0 0 0 0 0 0 0 0 0 0
0 0 0 0 0 0 0 0 0 0 0 0 0 2900 2900 2900 2900 2900 2900 2900 5800 5800 7220 8740 10360 12080 13900 13900 14400 14800 14900 15000 14900 14800 14400 13900 13900 12080 10360 8740 7220 5800 5800 2900 2900 2900 2900 2900 2900 2900 0 0 0 0 0 0 0 0 0 0 0 0 0
0 0 0 0 0 0 0 0 0 0 0 0 0 2900 2900 2900 2900 2900 2900 2900 5800 5800 7220 8740 10360 12080 13900 13900 14400 14400 14400 14400 14400 14400 14400 13900 13900 12080 10360 8740 7220 5800 5800 2900 2900 2900 2900 2900 2900 2900 0 0 0 0 0 0 0 0 0 0 0 0 0
0 0 0 0 0 0 0 0 0 0 0 0 0 2900 2900 2900 2900 2900 2900 2900 5800 5800 7220 8740 10360 12080 13900 13900 13900 13900 13900 13900 13900 13900 13900 13900 13900 12080 10360 8740 7220 5800 5800 2900 2900 2900 2900 2900 2900 2900 0 0 0 0 0 0 0 0 0 0 0 0 0
0 0 0 0 0 0 0 0 0 0 0 0 0 2900 2900 2900 2900 2900 2900 2900 5800 5800 7220 8740 10360 12080 13900 13900 13900 13900 13900 13900 13900 13900 13900 13900 13900 12080 10360 8740 7220 5800 5800 2900 2900 2900 2900 2900 2900 2900 0 0 0 0 0 0 0 0 0 0 0 0 0
0 0 0 0 0 0 0 0 0 0 0 0 0 2900 2900 2900 2900 2900 2900 2900 5800 5800 7220 8740 10360 12080 12080 12080 12080 12080 12080 12080 12080 12080 12080 12080 12080 12080 10360 8740 7220 5800 5800 2900 2900 2900 2900 2900 2900 2900 0 0 0 0 0 0 0 0 0 0 0 0 0
0 0 0 0 0 0 0 0 0 0 0 0 0 2900 2900 2900 2900 2900 2900 2900 5800 5800 7220 8740 10360 10360 10360 10360 10360 10360 10360 10360 10360 10360 10360 10360 10360 10360 10360 8740 7220 5800 5800 2900 2900 2900 2900 2900 2900 2900 0 0 0 0 0 0 0 0 0 0 0 0 0
0 0 0 0 0 0 0 0 0 0 0 0 0 2900 2900 2900 3240 3700 4280 4980 5800 5800 7220 8740 8740 8740 8740 8740 8740 8740 8740 8740 8740 8740 8740 8740 8740 8740 8740 8740 7220 5800 5800 4980 4280 3700 3240 2900 2900 2900 0 0 0 0 0 0 0 0 0 0 0 0 0
0 0 0 0 0 0 0 0 0 0 0 0 0 2900 2900 2900 3240 3700 4280 4980 5800 5800 7220 7220 7220 7220 7220 7220 7220 7220 7220 7220 7220 7220 7220 7220 7220 7220 7220 7220 7220 5800 5800 4980 4280 3700 3240 2900 2900 2900 0 0 0 0 0 0 0 0 0 0 0 0 0
0 0 0 0 0 0 0 0 0 0 0 0 0 2900 2900 2900 3240 3700 4280 4980 5800 5800 5800 5800 5800 5800 5800 5800 5800 5800 5800 5800 5800 5800 5800 5800 5800 5800 5800 5800 5800 5800 5800 4980 4280 3700 3240 2900 2900 2900 0 0 0 0 0 0 0 0 0 0 0 0 0
0 0 0 0 0 0 0 0 0 0 0 0 0 2900 2900 2900 3240 3700 4280 4980 5800 5800 5800 5800 5800 5800 5800 5800 5800 5800 5800 5800 5800 5800 5800 5800 5800 5800 5800 5800 5800 5800 5800 4980 4280 3700 3240 2900 2900 2900 0 0 0 0 0 0 0 0 0 0 0 0 0
0 0 0 0 0 0 0 0 0 0 0 0 0 2900 2900 2900 3240 3700 4280 4980 4980 4980 4980 4980 4980 2900 2900 2900 2900 2900 2900 2900 2900 2900 2900 2900 2900 2900 4980 4980 4980 4980 4980 4980 4280 3700 3240 2900 2900 2900 0 0 0 0 0 0 0 0 0 0 0 0 0
0 0 0 0 0 0 0 0 0 0 0 0 0 2900 2900 2900 3240 3700 4280 4280 4280 4280 4280 4280 4280 2900 2900 2900 2900 2900 2900 2900 2900 2900 2900 2900 2900 2900 4280 4280 4280 4280 4280 4280 4280 3700 3240 2900 2900 2900 0 0 0 0 0 0 0 0 0 0 0 0 0
0 0 0 0 0 0 0 0 0 0 0 0 0 2900 2900 2900 3240 3700 3700 3700 3700 3700 3700 3700 3700 2900 2900 2900 2900 2900 2900 2900 2900 2900 2900 2900 2900 2900 3700 3700 3700 3700 3700 3700 3700 3700 3240 2900 2900 2900 0 0 0 0 0 0 0 0 0 0 0 0 0
0 223 446 669 892 1115 1338 1561 1784 2007 2230 2453 2676 2900 2900 2900 3240 3240 3240 3240 3240 3240 3240 3240 3240 2900 2900 2900 2900 2900 2900 2900 2900 2900 2900 2900 2900 2900 3240 3240 3240 3240 3240 3240 3240 3240 3240 2900 2900 2900 2676 2453 2230 2007 1784 1561 1338 1115 892 669 446 223 0
0 223 446 669 892 1115 1338 1561 1784 2007 2230 2453 2676 2900 2900 2900 2900 2900 2900 2900 2900 2900 2900 2900 2900 2900 2900 2900 2900 2900 2900 2900 2900 2900 2900 2900 2900 2900 2900 2900 2900 2900 2900 2900 2900 2900 2900 2900 2900 2900 2676 2453 2230 2007 1784 1561 1338 1115 892 669 446 223 0
0 223 446 669 892 1115 1338 1561 1784 2007 2230 2453 2676 2900 2900 2900 2900 2900 2900 2900 2900 2900 2900 2900 2900 2900 2900 2900 2900 2900 2900 2900 2900 2900 2900 2900 2900 2900 2900 2900 2900 2900 2900 2900 2900 2900 2900 2900 2900 2900 2676 2453 2230 2007 1784 1561 1338 1115 892 669 446 223 0
0 223 446 669 892 1115 1338 1561 1784 2007 2230 2453 2676 2900 2900 2900 2900 2900 2900 2900 2900 2900 2900 2900 2900 2900 2900 2900 2900 2900 2900 2900 2900 2900 2900 2900 2900 2900 2900 2900 2900 2900 2900 2900 2900 2900 2900 2900 2900 2900 2676 2453 2230 2007 1784 1561 1338 1115 892 669 446 223 0
0 223 446 669 892 1115 1338 1561 1784 2007 2230 2453 2676 2676 2676 2676 2676 0 0 0 0 0 0 0 0 0 0 0 0 0 0 0 0 0 0 0 0 0 0 0 0 0 0 0 0 0 2676 2676 2676 2676 2676 2453 2230 2007 1784 1561 1338 1115 892 669 446 223 0
0 223 446 669 892 1115 1338 1561 1784 2007 2230 2453 2453 2453 2453 2453 2453 0 0 0 0 0 0 0 0 0 0 0 0 0 0 0 0 0 0 0 0 0 0 0 0 0 0 0 0 0 2453 2453 2453 2453 2453 2453 2230 2007 1784 1561 1338 1115 892 669 446 223 0
0 223 446 669 892 1115 1338 1561 1784 2007 2230 2230 2230 2230 2230 2230 2230 0 0 0 0 0 0 0 0 0 0 0 0 0 0 0 0 0 0 0 0 0 0 0 0 0 0 0 0 0 2230 2230 2230 2230 2230 2230 2230 2007 1784 1561 1338 1115 892 669 446 223 0
0 223 446 669 892 1115 1338 1561 1784 2007 2007 2007 2007 2007 2007 2007 2007 0 0 0 0 0 0 0 0 0 0 0 0 0 0 0 0 0 0 0 0 0 0 0 0 0 0 0 0 0 2007 2007 2007 2007 2007 2007 2007 2007 1784 1561 1338 1115 892 669 446 223 0
0 223 446 669 892 1115 1338 1561 1784 1784 1784 1784 1784 1784 1784 1784 1784 0 0 0 0 0 0 0 0 0 0 0 0 0 0 0 0 0 0 0 0 0 0 0 0 0 0 0 0 0 1784 1784 1784 1784 1784 1784 1784 1784 1784 1561 1338 1115 892 669 446 223 0
0 223 446 669 892 1115 1338 1561 1561 1561 1561 1561 1561 1561 1561 1561 1561 0 0 0 0 0 0 0 0 0 0 0 0 0 0 0 0 0 0 0 0 0 0 0 0 0 0 0 0 0 1561 1561 1561 1561 1561 1561 1561 1561 1561 1561 1338 1115 892 669 446 223 0
0 223 446 669 892 1115 1338 1338 1338 1338 1338 1338 1338 1338 1338 1338 1338 0 0 0 0 0 0 0 0 0 0 0 0 0 0 0 0 0 0 0 0 0 0 0 0 0 0 0 0 0 1338 1338 1338 1338 1338 1338 1338 1338 1338 1338 1338 1115 892 669 446 223 0
0 223 446 669 892 1115 1115 1115 1115 1115 1115 1115 1115 1115 1115 1115 1115 0 0 0 0 0 0 0 0 0 0 0 0 0 0 0 0 0 0 0 0 0 0 0 0 0 0 0 0 0 1115 1115 1115 1115 1115 1115 1115 1115 1115 1115 1115 1115 892 669 446 223 0
0 223 446 669 892 892 892 892 892 892 892 892 892 892 892 892 892 0 0 0 0 0 0 0 0 0 0 0 0 0 0 0 0 0 0 0 0 0 0 0 0 0 0 0 0 0 892 892 892 892 892 892 892 892 892 892 892 892 892 669 446 223 0
0 223 446 669 669 669 669 669 669 669 669 669 669 669 669 669 669 0 0 0 0 0 0 0 0 0 0 0 0 0 0 0 0 0 0 0 0 0 0 0 0 0 0 0 0 0 669 669 669 669 669 669 669 669 669 669 669 669 669 669 446 223 0
0 223 446 446 446 446 446 446 446 446 446 446 446 446 446 446 446 0 0 0 0 0 0 0 0 0 0 0 0 0 0 0 0 0 0 0 0 0 0 0 0 0 0 0 0 0 446 446 446 446 446 446 446 446 446 446 446 446 446 446 446 223 0
0 223 223 223 223 223 223 223 223 223 223 223 223 223 223 223 223 0 0 0 0 0 0 0 0 0 0 0 0 0 0 0 0 0 0 0 0 0 0 0 0 0 0 0 0 0 223 223 223 223 223 223 223 223 223 223 223 223 223 223 223 223 0
0 0 0 0 0 0 0 0 0 0 0 0 0 0 0 0 0 0 0 0 0 0 0 0 0 0 0 0 0 0 0 0 0 0 0 0 0 0 0 0 0 0 0 0 0 0 0 0 0 0 0 0 0 0 0 0 0 0 0 0 0 0 0
